#######
#     #
##### #
#     #
# ### #
# #   #
# ## ##

