######## ##########
# #   #   # # #   #
#   # # # # #   # #
### # # # # # #####
#   # # # #   #   #
### #   #   ### # #
#   ##### ###   ###
# ### ### ### #####
# #   #   # # #   #
### ### ### # ### #
#        #  # #   #
########      #   #
#        ###      #
## ################
d
