##### ###########
#               #
# ############# #
#     #     # ###
##### # # # # # #
# #   # # # # # #
# # # ### # # # #
#   # #   #   # #
##### # ##### # #
#     # # #   # #
# ##### # # ### #
#         #     #
######### ##### #
#   #   # #     #
# # # # # # # ###
# #   #   # #   #
############### #

